.........__.........
.___.___.__.___.___.
.P..................
.___._.______._.___.
....._...__..._.....
____.___.__.___.____
____._........_.____
.......______.......
____._.______._.____
____._........_.____
.......______.......
.__.__.______.__.__.
.._.............._..
_._.__.______.__._._
....__...__...__....
._______.__._______.
....................
____________________
____________________
____________________