.........__.........
M___.___.__.___.___M
.P..................
.___._.______._.___.
....._...__..._.....
____.___.__.___.____
____._........_.____
.......______.......
____._.______._.____
____._........_.____
.......______.......
.__.__.______.__.__.
.._.............._..
_._.__.______.__._._
....__...__...__....
M_______.__._______M
....................
____________________
____________________
____________________